%%%%%%%
%    P%
% %%% %
%  %  %
%%   %%
%.  %%%%
%%%%%%%
